"filename", "language", "Python", "comment", "blank", "total"
"c:\Users\rapha\OneDrive\Tale\Nsi\Python\Uno\assets.py", "Python", 13, 1, 7, 21
"c:\Users\rapha\OneDrive\Tale\Nsi\Python\Uno\classes\box.py", "Python", -1, 10, 0, 9
"c:\Users\rapha\OneDrive\Tale\Nsi\Python\Uno\classes\button.py", "Python", 0, 24, 4, 28
"c:\Users\rapha\OneDrive\Tale\Nsi\Python\Uno\classes\button_family.py", "Python", 3, 26, 6, 35
"c:\Users\rapha\OneDrive\Tale\Nsi\Python\Uno\classes\card.py", "Python", 243, 18, 110, 371
"c:\Users\rapha\OneDrive\Tale\Nsi\Python\Uno\classes\deck.py", "Python", 204, 9, 82, 295
"c:\Users\rapha\OneDrive\Tale\Nsi\Python\Uno\classes\game.py", "Python", -88, 2, -49, -135
"c:\Users\rapha\OneDrive\Tale\Nsi\Python\Uno\classes\image.py", "Python", 4, 8, 1, 13
"c:\Users\rapha\OneDrive\Tale\Nsi\Python\Uno\classes\input_field.py", "Python", 0, 6, 3, 9
"c:\Users\rapha\OneDrive\Tale\Nsi\Python\Uno\classes\manager.py", "Python", -2, 15, 5, 18
"c:\Users\rapha\OneDrive\Tale\Nsi\Python\Uno\classes\splash_title.py", "Python", 60, 3, 31, 94
"c:\Users\rapha\OneDrive\Tale\Nsi\Python\Uno\classes\timer.py", "Python", -2, 7, -1, 4
"c:\Users\rapha\OneDrive\Tale\Nsi\Python\Uno\classes\title.py", "Python", 4, 11, 2, 17
"c:\Users\rapha\OneDrive\Tale\Nsi\Python\Uno\classes\transition.py", "Python", -3, 21, 12, 30
"c:\Users\rapha\OneDrive\Tale\Nsi\Python\Uno\elements\game_elements.py", "Python", 35, 3, 19, 57
"c:\Users\rapha\OneDrive\Tale\Nsi\Python\Uno\elements\nouvelle_partie.py", "Python", -7, 7, 1, 1
"c:\Users\rapha\OneDrive\Tale\Nsi\Python\Uno\elements\start_menu.py", "Python", -6, 5, 1, 0
"c:\Users\rapha\OneDrive\Tale\Nsi\Python\Uno\main.py", "Python", 0, -1, 2, 1
"c:\Users\rapha\OneDrive\Tale\Nsi\Python\Uno\test.py", "Python", -16, 1, -2, -17
"c:\Users\rapha\OneDrive\Tale\Nsi\Python\Uno\utils.py", "Python", 8, 6, 6, 20
"Total", "-", 449, 182, 240, 871