"filename", "language", "Python", "comment", "blank", "total"
"c:\Users\rapha\OneDrive\Tale\Nsi\Python\Uno\assets.py", "Python", 41, 1, 11, 53
"c:\Users\rapha\OneDrive\Tale\Nsi\Python\Uno\classes\box.py", "Python", 97, 16, 36, 149
"c:\Users\rapha\OneDrive\Tale\Nsi\Python\Uno\classes\button.py", "Python", 195, 34, 66, 295
"c:\Users\rapha\OneDrive\Tale\Nsi\Python\Uno\classes\button_family.py", "Python", 34, 36, 28, 98
"c:\Users\rapha\OneDrive\Tale\Nsi\Python\Uno\classes\card.py", "Python", 243, 18, 110, 371
"c:\Users\rapha\OneDrive\Tale\Nsi\Python\Uno\classes\deck.py", "Python", 204, 9, 82, 295
"c:\Users\rapha\OneDrive\Tale\Nsi\Python\Uno\classes\game.py", "Python", 31, 2, 21, 54
"c:\Users\rapha\OneDrive\Tale\Nsi\Python\Uno\classes\image.py", "Python", 85, 15, 28, 128
"c:\Users\rapha\OneDrive\Tale\Nsi\Python\Uno\classes\input_field.py", "Python", 199, 6, 80, 285
"c:\Users\rapha\OneDrive\Tale\Nsi\Python\Uno\classes\manager.py", "Python", 71, 18, 24, 113
"c:\Users\rapha\OneDrive\Tale\Nsi\Python\Uno\classes\splash_title.py", "Python", 60, 3, 31, 94
"c:\Users\rapha\OneDrive\Tale\Nsi\Python\Uno\classes\timer.py", "Python", 13, 7, 10, 30
"c:\Users\rapha\OneDrive\Tale\Nsi\Python\Uno\classes\title.py", "Python", 74, 20, 31, 125
"c:\Users\rapha\OneDrive\Tale\Nsi\Python\Uno\classes\transition.py", "Python", 39, 21, 30, 90
"c:\Users\rapha\OneDrive\Tale\Nsi\Python\Uno\elements\game_elements.py", "Python", 90, 3, 38, 131
"c:\Users\rapha\OneDrive\Tale\Nsi\Python\Uno\elements\nouvelle_partie.py", "Python", 441, 13, 72, 526
"c:\Users\rapha\OneDrive\Tale\Nsi\Python\Uno\elements\start_menu.py", "Python", 155, 5, 31, 191
"c:\Users\rapha\OneDrive\Tale\Nsi\Python\Uno\main.py", "Python", 5, 3, 4, 12
"c:\Users\rapha\OneDrive\Tale\Nsi\Python\Uno\test.py", "Python", 3, 1, 1, 5
"c:\Users\rapha\OneDrive\Tale\Nsi\Python\Uno\utils.py", "Python", 66, 13, 11, 90
"Total", "-", 2146, 244, 745, 3135