"filename", "language", "Python", "comment", "blank", "total"
"c:\Users\rapha\OneDrive\Tale\Nsi\Python\Uno\assets.py", "Python", 25, 0, 4, 29
"c:\Users\rapha\OneDrive\Tale\Nsi\Python\Uno\classes\box.py", "Python", -5, 0, -1, -6
"c:\Users\rapha\OneDrive\Tale\Nsi\Python\Uno\classes\button.py", "Python", 30, 3, 9, 42
"c:\Users\rapha\OneDrive\Tale\Nsi\Python\Uno\classes\button_family.py", "Python", 31, 10, 22, 63
"c:\Users\rapha\OneDrive\Tale\Nsi\Python\Uno\classes\button_group.py", "Python", -2, 0, 0, -2
"c:\Users\rapha\OneDrive\Tale\Nsi\Python\Uno\classes\game.py", "Python", 119, 0, 70, 189
"c:\Users\rapha\OneDrive\Tale\Nsi\Python\Uno\classes\image.py", "Python", 7, 0, 3, 10
"c:\Users\rapha\OneDrive\Tale\Nsi\Python\Uno\classes\input_field.py", "Python", 55, -5, 31, 81
"c:\Users\rapha\OneDrive\Tale\Nsi\Python\Uno\classes\manager.py", "Python", 9, 0, 2, 11
"c:\Users\rapha\OneDrive\Tale\Nsi\Python\Uno\classes\timer.py", "Python", 15, 0, 11, 26
"c:\Users\rapha\OneDrive\Tale\Nsi\Python\Uno\classes\title.py", "Python", 3, 0, 2, 5
"c:\Users\rapha\OneDrive\Tale\Nsi\Python\Uno\classes\transition.py", "Python", 6, 0, 1, 7
"c:\Users\rapha\OneDrive\Tale\Nsi\Python\Uno\elements\game_elements.py", "Python", 55, 0, 19, 74
"c:\Users\rapha\OneDrive\Tale\Nsi\Python\Uno\elements\multijoueur_selection_menu.py", "Python", -169, -4, -40, -213
"c:\Users\rapha\OneDrive\Tale\Nsi\Python\Uno\elements\nouvelle_partie.py", "Python", 448, 6, 71, 525
"c:\Users\rapha\OneDrive\Tale\Nsi\Python\Uno\elements\start_menu.py", "Python", 0, -1, 3, 2
"c:\Users\rapha\OneDrive\Tale\Nsi\Python\Uno\main.py", "Python", 1, 2, 0, 3
"c:\Users\rapha\OneDrive\Tale\Nsi\Python\Uno\test.py", "Python", 14, 0, 3, 17
"Total", "-", 642, 11, 210, 863