"filename", "language", "Python", "Markdown", "comment", "blank", "total"
"c:\Users\rapha\Desktop\Code\Uno\assets.py", "Python", 49, 0, 1, 11, 61
"c:\Users\rapha\Desktop\Code\Uno\classes\box.py", "Python", 105, 0, 21, 40, 166
"c:\Users\rapha\Desktop\Code\Uno\classes\button.py", "Python", 199, 0, 34, 66, 299
"c:\Users\rapha\Desktop\Code\Uno\classes\button_family.py", "Python", 34, 0, 36, 28, 98
"c:\Users\rapha\Desktop\Code\Uno\classes\card.py", "Python", 268, 0, 17, 130, 415
"c:\Users\rapha\Desktop\Code\Uno\classes\deck.py", "Python", 272, 0, 8, 104, 384
"c:\Users\rapha\Desktop\Code\Uno\classes\game.py", "Python", 62, 0, 0, 37, 99
"c:\Users\rapha\Desktop\Code\Uno\classes\image.py", "Python", 89, 0, 15, 29, 133
"c:\Users\rapha\Desktop\Code\Uno\classes\input_field.py", "Python", 203, 0, 6, 80, 289
"c:\Users\rapha\Desktop\Code\Uno\classes\manager.py", "Python", 71, 0, 18, 26, 115
"c:\Users\rapha\Desktop\Code\Uno\classes\moving_image.py", "Python", 35, 0, 1, 9, 45
"c:\Users\rapha\Desktop\Code\Uno\classes\player_name.py", "Python", 61, 0, 0, 19, 80
"c:\Users\rapha\Desktop\Code\Uno\classes\splash_title.py", "Python", 129, 0, 6, 54, 189
"c:\Users\rapha\Desktop\Code\Uno\classes\timer.py", "Python", 15, 0, 7, 12, 34
"c:\Users\rapha\Desktop\Code\Uno\classes\title.py", "Python", 84, 0, 20, 35, 139
"c:\Users\rapha\Desktop\Code\Uno\classes\transition.py", "Python", 59, 0, 24, 35, 118
"c:\Users\rapha\Desktop\Code\Uno\elements\game_elements.py", "Python", 560, 0, 3, 94, 657
"c:\Users\rapha\Desktop\Code\Uno\elements\nouvelle_partie.py", "Python", 399, 0, 13, 52, 464
"c:\Users\rapha\Desktop\Code\Uno\elements\start_menu.py", "Python", 159, 0, 5, 25, 189
"c:\Users\rapha\Desktop\Code\Uno\main.py", "Python", 5, 0, 3, 4, 12
"c:\Users\rapha\Desktop\Code\Uno\readme.md", "Markdown", 0, 3, 0, 2, 5
"c:\Users\rapha\Desktop\Code\Uno\test.py", "Python", 7, 0, 0, 1, 8
"c:\Users\rapha\Desktop\Code\Uno\utils.py", "Python", 68, 0, 12, 13, 93
"c:\Users\rapha\OneDrive\Tale\Nsi\Python\Uno\assets.py", "Python", -41, 0, -1, -11, -53
"c:\Users\rapha\OneDrive\Tale\Nsi\Python\Uno\classes\box.py", "Python", -97, 0, -16, -36, -149
"c:\Users\rapha\OneDrive\Tale\Nsi\Python\Uno\classes\button.py", "Python", -195, 0, -34, -66, -295
"c:\Users\rapha\OneDrive\Tale\Nsi\Python\Uno\classes\button_family.py", "Python", -34, 0, -36, -28, -98
"c:\Users\rapha\OneDrive\Tale\Nsi\Python\Uno\classes\card.py", "Python", -243, 0, -18, -110, -371
"c:\Users\rapha\OneDrive\Tale\Nsi\Python\Uno\classes\deck.py", "Python", -204, 0, -9, -82, -295
"c:\Users\rapha\OneDrive\Tale\Nsi\Python\Uno\classes\game.py", "Python", -31, 0, -2, -21, -54
"c:\Users\rapha\OneDrive\Tale\Nsi\Python\Uno\classes\image.py", "Python", -85, 0, -15, -28, -128
"c:\Users\rapha\OneDrive\Tale\Nsi\Python\Uno\classes\input_field.py", "Python", -199, 0, -6, -80, -285
"c:\Users\rapha\OneDrive\Tale\Nsi\Python\Uno\classes\manager.py", "Python", -71, 0, -18, -24, -113
"c:\Users\rapha\OneDrive\Tale\Nsi\Python\Uno\classes\splash_title.py", "Python", -60, 0, -3, -31, -94
"c:\Users\rapha\OneDrive\Tale\Nsi\Python\Uno\classes\timer.py", "Python", -13, 0, -7, -10, -30
"c:\Users\rapha\OneDrive\Tale\Nsi\Python\Uno\classes\title.py", "Python", -74, 0, -20, -31, -125
"c:\Users\rapha\OneDrive\Tale\Nsi\Python\Uno\classes\transition.py", "Python", -39, 0, -21, -30, -90
"c:\Users\rapha\OneDrive\Tale\Nsi\Python\Uno\elements\game_elements.py", "Python", -90, 0, -3, -38, -131
"c:\Users\rapha\OneDrive\Tale\Nsi\Python\Uno\elements\nouvelle_partie.py", "Python", -441, 0, -13, -72, -526
"c:\Users\rapha\OneDrive\Tale\Nsi\Python\Uno\elements\start_menu.py", "Python", -155, 0, -5, -31, -191
"c:\Users\rapha\OneDrive\Tale\Nsi\Python\Uno\main.py", "Python", -5, 0, -3, -4, -12
"c:\Users\rapha\OneDrive\Tale\Nsi\Python\Uno\test.py", "Python", -3, 0, -1, -1, -5
"c:\Users\rapha\OneDrive\Tale\Nsi\Python\Uno\utils.py", "Python", -66, 0, -13, -11, -90
"Total", "-", 787, 3, 6, 161, 957